"aa" = (/turf/stalker/floor/digable/grass,/area/stalker)
"ab" = (/turf/simulated/wall/stalker/beton_agro,/area/stalker/svalka/buildings)
"ac" = (/obj/structure/bed/stalker/metal/matras,/turf/stalker/floor/agroprom/beton,/area/stalker/svalka/buildings)
"ad" = (/turf/stalker/floor/agroprom/beton,/area/stalker/svalka/buildings)
"ae" = (/obj/machinery/light/small{icon_state = "bulb1"; dir = 1},/turf/stalker/floor/agroprom/beton,/area/stalker/svalka/buildings)
"af" = (/obj/structure/mineral_door/wood/armywood,/turf/stalker/floor/agroprom/beton,/area/stalker/svalka/buildings)
"ag" = (/turf/stalker/floor/agroprom/beton,/area/stalker)
"ah" = (/obj/machinery/light/small{icon_state = "bulb1"; dir = 4},/turf/stalker/floor/agroprom/beton,/area/stalker/svalka/buildings)
"ai" = (/obj/machinery/light/small{icon_state = "bulb1"; dir = 8},/turf/stalker/floor/agroprom/beton,/area/stalker/svalka/buildings)
"aj" = (/obj/effect/landmark/latejoin/army/sergeant,/turf/stalker/floor/agroprom/beton,/area/stalker/svalka/buildings)
"ak" = (/obj/effect/landmark/latejoin/army/private,/turf/stalker/floor/agroprom/beton,/area/stalker/svalka/buildings)
"al" = (/obj/structure/mineral_door/wood/armywood,/turf/stalker/floor/agroprom/gryaz,/area/stalker/svalka/buildings)
"am" = (/turf/indestructible/splashscreen,/area/stalker)
"an" = (/obj/structure/table/stalker/wood,/turf/stalker/floor/agroprom/beton,/area/stalker/svalka/buildings)
"ao" = (/obj/structure/rack/polka,/turf/stalker/floor/agroprom/beton,/area/stalker/svalka/buildings)
"ap" = (/obj/structure/bed/chair/wood/normal{dir = 8; step_x = 0},/turf/stalker/floor/agroprom/beton,/area/stalker/svalka/buildings)
"aq" = (/obj/machinery/light/small,/turf/stalker/floor/agroprom/beton,/area/stalker/svalka/buildings)
"ar" = (/obj/machinery/light,/turf/stalker/floor/agroprom/beton,/area/stalker/svalka/buildings)
"as" = (/obj/structure/mineral_door/steel/blast,/turf/stalker/floor/agroprom/beton,/area/stalker/svalka/buildings)
"at" = (/obj/structure/mineral_door/wood/armywood,/turf/simulated/wall/stalker/beton_agro,/area/stalker/svalka/buildings)
"au" = (/obj/structure/closet/stalker/shkaf,/turf/stalker/floor/agroprom/beton,/area/stalker/svalka/buildings)
"av" = (/turf/simulated/wall/stalker/beton_agro,/area/stalker)
"aw" = (/turf/simulated/floor/plasteel/stairs/stalker{tag = "icon-ladder (EAST)"; icon_state = "ladder_left"; dir = 4},/area/stalker)
"ax" = (/obj/structure/bed/chair/wood/normal,/turf/stalker/floor/agroprom/beton,/area/stalker/svalka/buildings)
"ay" = (/obj/machinery/light/small{icon_state = "bulb1"; dir = 4},/obj/structure/closet/stalker/shkaf,/turf/stalker/floor/agroprom/beton,/area/stalker/svalka/buildings)
"az" = (/obj/effect/step_trigger/teleporter{teleport_x = 62; teleport_y = 176; teleport_z = 2},/turf/simulated/floor/plasteel/stairs/stalker{tag = "icon-ladder (EAST)"; icon_state = "ladder_left"; dir = 4},/area/stalker)
"aA" = (/obj/machinery/light/small{icon_state = "bulb1"; dir = 8},/obj/structure/rack/polka,/turf/stalker/floor/agroprom/beton,/area/stalker/svalka/buildings)
"aB" = (/obj/machinery/light/small{icon_state = "bulb1"; dir = 4},/obj/structure/rack/polka,/turf/stalker/floor/agroprom/beton,/area/stalker/svalka/buildings)
"aC" = (/obj/effect/step_trigger/teleporter{teleport_x = 62; teleport_y = 176; teleport_z = 2},/turf/simulated/floor/plasteel/stairs/stalker{tag = "icon-ladder (EAST)"; icon_state = "ladder_left"; dir = 4},/area/stalker)
"be" = (/obj/effect/landmark/start,/turf/simulated/floor/plating,/area/stalker)
"bp" = (/turf/simulated/wall/stalker/bricks,/area/stalker)
"bv" = (/turf/indestructible/riveted,/area/stalker)

(1,1,1) = {"
aaaaaaaaaaaaaaaaaaaaaaaaaaaaaaaaaaaaaaaaaaaaaaaaaaaaaaaaaaaaaaaaaaaaaaaaaaaaaaaaaaaaaaaaaaaaaaaaaaaa
aaaaaaaaaaaaaaaaaaaaaaaaaaaaaaaaaaaaaaaaaaaaaaaaaaaaaaaaaaaaaaaaaaaaaaaaaaaaaaaaaaaaaaaaaaaaaaaaaaaa
aaaaaaaaaaaaaaaaaaaaaaaaaaaaaaaaaaaaaaaaaaaaaaaaaaaaaaaaaaaaaaaaaaaaaaaaaaaaaaaaaaaaaaaaaaaaaaaaaaaa
aaaaaaaaaaaaaaaaaaaaaaaaaaaaaaaaaaaaaaaaaaaaaaaaaaaaaaaaaaaaaaaaaaaaaaaaaaaaaaaaaaaaaaaaaaaaaaaaaaaa
aaaaaaaaaaaaaaaaaaaaaaaaaaaaaaaaaaaaaaaaaaaaaaaaaaaaaaaaaaaaaaaaaaaaaaaaaaaaaaaaaaaaaaaaaaaaaaaaaaaa
aaaaaaaaaaaaaaaaaaaaaaaaaaaaaaaaaaaaaaaaaaaaaaaaaaaaaaaaaaaaaaaaaaaaaaaaaaaaaaaaaaaaaaaaaaaaaaaaaaaa
aaaaaaaaaaaaaaaaaaaaababababababababababababababababababababababababaaaaaaaaaaaaaaaaaaaaaaaaaaaaaaaa
aaaaaaaaaaaaaaaaaaaaabacadaeadacauacauacadaeadacauacadadafadadaeadabaaaaaaaaaaaaaaaaaaaaaaaaaaaaaaaa
aaaaaaaaaaaaaaaaaaaaabadadadadadadadadadadadadadadadadadabadadadadabaaaaaaaaaaaaaaaaaaaaaaaaaaaaaaaa
aaaaaaaaaaaaaaaaaaaaabadadadadadauadadadadadadadadadadadabadadadadabaaaaaaaaaaaaaaaaaaaaaaaaaaaaaaaa
aaaaaaaaaaaaaaaaaaaaabadadadadahabaiadadajajajadayabaiadabadadadadabaaaaaaaaaaaaaaaaaaaaaaaaaaaaaaaa
aaaaaaaaaaaaaaaaaaaaabadadadadadadadadadadadadadadadadadabadadadadabaaaaaaaaaaaaaaaaaaaaaaaaaaaaaaaa
aaaaaaaaaaaaaaaaaaaaabacadadadadacadadakakakakakakadadacabadadadadabaaaaaaaaaaaaaaaaaaaaaaaaaaaaaaaa
aaaaaaaaaaaaaaaaaaaaababalabababababafabababababababababababababababaaaaaaaaaaaaaaaaaaaaaaaaaaaaaaaa
aaaaaaaaaaaaaaaaaaaaabanadaeaoaoabadadadabaoanauadabadaeadadaeadadabaaaaaaaaaaaaaaaaaaaaaaaaaaaaaaaa
aaaaaaaaaaaaaaaaaaaaabanadadadadabadadadabadadadadabadadadadanadadabaaaaaaaaaaaaaaaaaaaaaaaaaaaaaaaa
aaaaaaaaaaaaaaaaaaaaabanadanaoaoabadadadabadadadadafadadadadanapadabaaaaaaaaaaaaaaaaaaaaaaaaaaaaaaaa
aaaaaaaaaaaaaaaaaaaaabanadaqadadabaqadadafadarananabadadadadanadadabaaaaaaaaaaaaaaaaaaaaaaaaaaaaaaaa
aaaaaaaaaaaaaaaaaaaaababababababababafabababababababababafabababababaaaaaaaaaaaaaaaaaaaaaaaaaaaaaaaa
aaaaaaaaaaaaaaaaaaaaabadadadadadabadadadabadadadadabaoadadaoabadadabavavavavaaaaaaaaaaaaaaaaaaaaaaaa
aaaaaaaaaaaaaaaaaaaaabadadadadadabadadadabadadadadabadadadadabadadasawawaCavaaaaaaaaaaaaaaaaaaaaaaaa
aaaaaaaaaaaaaaaaaaaaabadadadadahabadadadabaiadadadabaAadadaBabadadasawawazavaaaaaaaaaaaaaaaaaaaaaaaa
aaaaaaaaaaaaaaaaaaaaabadadadadadabadadadabadadadadabadadadadabadadabavavavavaaaaaaaaaaaaaaaaaaaaaaaa
aaaaaaaaaaaaaaaaaaaaabadadadadadabadadadabadadadadabaoadadaoabadadabaaaaaaaaaaaaaaaaaaaaaaaaaaaaaaaa
aaaaaaaaaaaaaaaaaaaaabadadadadadafadadaqafadadadadabadadadadabadadabaaaaaaaaaaaaaaaaaaaaaaaaaaaaaaaa
aaaaaaaaaaaaaaaaaaaaababababababababatabababababababaAadadaBabadadabaaaaaaaaaaaaaaaaaaaaaaaaaaaaaaaa
aaaaaaaaaaaaaaaaaaaaabadadadadadabadadadabaxauauauabadadadadabadadabaaaaaaaaaaaaaaaaaaaaaaaaaaaaaaaa
aaaaaaaaaaaaaaaaaaaaabadadadadadabadadadabadadadadabaoaxadaoabadadabaaaaaaaaaaaaaaaaaaaaaaaaaaaaaaaa
aaaaaaaaaaaaaaaaaaaaabadadadadadabadadadabadadaxadababananababadadabaaaaaaaaaaaaaaaaaaaaaaaaaaaaaaaa
aaaaaaaaaaaaaaaaaaaaabadadadadahabaiadadabaianananabadadadadabadadabaaaaaaaaaaaaaaaaaaaaaaaaaaaaaaaa
aaaaaaaaaaaaaaaaaaaaabadadadadadabadadadabadadadadafadadadadafadadabaaaaaaaaaaaaaaaaaaaaaaaaaaaaaaaa
aaaaaaaaaaaaaaaaaaaaabadadadadadabadadadabadadadadabadaqadadabadadabaaaaaaaaaaaaaaaaaaaaaaaaaaaaaaaa
agaaaaaaaaaaaaaaaaaaabadadadadadafadadadafadadadadababababababadadabaaaaaaaaaaaaaaaaaaaaaaaaaaaaaaaa
agaaaaaaaaaaaaaaaaaaababababababababababababababababadadadadababababaaaaaaaaaaaaaaaaaaaaaaaaaaaaaaaa
aaaaaaaaaaaaaaaaaaaaaaaaaaaaaaaaaaaaaaaaaaaaaaaaaaaaaaaaaaaaaaaaaaaaaaaaaaaaaaaaaaaaaaaaaaaaaaaaaaaa
aaaaaaaaaaaaaaaaaaaaaaaaaaaaaaaaaaaaaaaaaaaaaaaaaaaaaaaaaaaaaaaaaaaaaaaaaaaaaaaaaaaaaaaaaaaaaaaaaaaa
aaaaaaaaaaaaaaaaaaaaaaaaaaaaaaaaaaaaaaaaaaaaaaaaaaaaaaaaaaaaaaaaaaaaaaaaaaaaaaaaaaaaaaaaaaaaaaaaaaaa
aaaaaaaaaaaaaaaaaaaaaaaaaaaaaaaaaaaaaaaaaaaaaaaaaaaaaaaaaaaaaaaaaaaaaaaaaaaaaaaaaaaaaaaaaaaaaaaaaaaa
aaaaaaaaaaaaaaaaaaaaaaaaaaaaaaaaaaaaaaaaaaaaaaaaaaaaaaaaaaaaaaaaaaaaaaaaaaaaaaaaaaaaaaaaaaaaaaaaaaaa
aaaaaaaaaaaaaaaaaaaaaaaaaaaaaaaaaaaaaaaaaaaaaaaaaaaaaaaaaaaaaaaaaaaaaaaaaaaaaaaaaaaaaaaaaaaaaaaaaaaa
aaaaaaaaaaaaaaaaaaaaaaaaaaaaaaaaaaaaaaaaaaaaaaaaaaaaaaaaaaaaaaaaaaaaaaaaaaaaaaaaaaaaaaaaaaaaaaaaaaaa
aaaaaaaaaaaaaaaaaaaaaaaaaaaaaaaaaaaaaaaaaaaaaaaaaaaaaaaaaaaaaaaaaaaaaaaaaaaaaaaaaaaaaaaaaaaaaaaaaaaa
aaaaaaaaaaaaaaaaaaaaaaaaaaaaaaaaaaaaaaaaaaaaaaaaaaaaaaaaaaaaaaaaaaaaaaaaaaaaaaaaaaaaaaaaaaaaaaaaaaaa
aaaaaaaaaaaaaaaaaaaaaaaaaaaaaaaaaaaaaaaaaaaaaaaaaaaaaaaaaaaaaaaaaaaaaaaaaaaaaaaaaaaaaaaaaaaaaaaaaaaa
aaaaaaaaaaaaaaaaaaaaaaaaaaaaaaaaaaaaaaaaaaaaaaaaaaaaaaaaaaaaaaaaaaaaaaaaaaaaaaaaaaaaaaaaaaaaaaaaaaaa
aaaaaaaaaaaaaaaaaaaaaaaaaaaaaaaaaaaaaaaaaaaaaaaaaaaaaaaaaaaaaaaaaaaaaaaaaaaaaaaaaaaaaaaaaaaaaaaaaaaa
aaaaaaaaaaaaaaaaaaaaaaaaaaaaaaaaaaaaaaaaaaaaaaaaaaaaaaaaaaaaaaaaaaaaaaaaaaaaaaaaaaaaaaaaaaaaaaaaaaaa
aaaaaaaaaaaaaaaaaaaaaaaaaaaaaaaaaaaaaaaaaaaaaaaaaaaaaaaaaaaaaaaaaaaaaaaaaaaaaaaaaaaaaaaaaaaaaaaaaaaa
aaaaaaaaaaaaaaaaaaaaaaaaaaaaaaaaaaaaaaaaaaaaaaaaaaaaaaaaaaaaaaaaaaaaaaaaaaaaaaaaaaaaaaaaaaaaaaaaaaaa
aaaaaaaaaaaaaaaaaaaaaaaaaaaaaaaaaaaaaaaaaaaaaaaaaaaaaaaaaaaaaaaaaaaaaaaaaaaaaaaaaaaaaaaaaaaaaaaaaaaa
aaaaaaaaaaaaaaaaaaaaaaaaaaaaaaaaaaaaaaaaaaaaaaaaaaaaaaaaaaaaaaaaaaaaaaaaaaaaaaaaaaaaaaaaaaaaaaaaaaaa
aaaaaaaaaaaaaaaaaaaaaaaaaaaaaaaaaaaaaaaaaaaaaaaaaaaaaaaaaaaaaaaaaaaaaaaaaaaaaaaaaaaaaaaaaaaaaaaaaaaa
aaaaaaaaaaaaaaaaaaaaaaaaaaaaaaaaaaaaaaaaaaaaaaaaaaaaaaaaaaaaaaaaaaaaaaaaaaaaaaaaaaaaaaaaaaaaaaaaaaaa
bpbpbpbpbpbpbpbpbpbpbpbpbpbpbpbpbpaaaaaaaaaaaaaaaaaaaaaaaaaaaaaaaaaaaaaaaaaaaaaaaaaaaaaaaaaaaaaaaaaa
bpbvbvbvbvbvbvbvbvbvbvbvbvbvbvbvbpaaaaaaaaaaaaaaaaaaaaaaaaaaaaaaaaaaaaaaaaaaaaaaaaaaaaaaaaaaaaaaaaaa
bpbvbvbvbvbvbvbvbvbvbvbvbvbvbvbvbpaaaaaaaaaaaaaaaaaaaaaaaaaaaaaaaaaaaaaaaaaaaaaaaaaaaaaaaaaaaaaaaaaa
bpbvbvbvbvbvbvbvbvbvbvbvbvbvbvbvbpaaaaaaaaaaaaaaaaaaaaaaaaaaaaaaaaaaaaaaaaaaaaaaaaaaaaaaaaaaaaaaaaaa
bpbvbvbvbvbvbvbvbvbvbvbvbvbvbvbvbpaaaaaaaaaaaaaaaaaaaaaaaaaaaaaaaaaaaaaaaaaaaaaaaaaaaaaaaaaaaaaaaaaa
bpbvbvbvbvbvbvbvbvbvbvbvbvbvbvbvbpaaaaaaaaaaaaaaaaaaaaaaaaaaaaaaaaaaaaaaaaaaaaaaaaaaaaaaaaaaaaaaaaaa
bpbvbvbvbvbvbvbvbvbvbvbvbvbvbvbvbpaaaaaaaaaaaaaaaaaaaaaaaaaaaaaaaaaaaaaaaaaaaaaaaaaaaaaaaaaaaaaaaaaa
bpbvbvbvbvbvbvbvbvbvbvbvbvbvbvbvbpaaaaaaaaaaaaaaaaaaaaaaaaaaaaaaaaaaaaaaaaaaaaaaaaaaaaaaaaaaaaaaaaaa
bpbvbvbvbvbvbvbvbebvbvbvbvbvbvbvbpaaaaaaaaaaaaaaaaaaaaaaaaaaaaaaaaaaaaaaaaaaaaaaaaaaaaaaaaaaaaaaaaaa
bpbvbvbvbvbvbvbvbvbvbvbvbvbvbvbvbpaaaaaaaaaaaaaaaaaaaaaaaaaaaaaaaaaaaaaaaaaaaaaaaaaaaaaaaaaaaaaaaaaa
bpbvbvbvbvbvbvbvbvbvbvbvbvbvbvbvbpaaaaaaaaaaaaaaaaaaaaaaaaaaaaaaaaaaaaaaaaaaaaaaaaaaaaaaaaaaaaaaaaaa
bpbvbvbvbvbvbvbvbvbvbvbvbvbvbvbvbpaaaaaaaaaaaaaaaaaaaaaaaaaaaaaaaaaaaaaaaaaaaaaaaaaaaaaaaaaaaaaaaaaa
bpbvbvbvbvbvbvbvbvbvbvbvbvbvbvbvbpaaaaaaaaaaaaaaaaaaaaaaaaaaaaaaaaaaaaaaaaaaaaaaaaaaaaaaaaaaaaaaaaaa
bpbvbvbvbvbvbvbvbvbvbvbvbvbvbvbvbpaaaaaaaaaaaaaaaaaaaaaaaaaaaaaaaaaaaaaaaaaaaaaaaaaaaaaaaaaaaaaaaaaa
bpbvbvbvbvbvbvbvbvbvbvbvbvbvbvbvbpaaaaaaaaaaaaaaaaaaaaaaaaaaaaaaaaaaaaaaaaaaaaaaaaaaaaaaaaaaaaaaaaaa
bpambvbvbvbvbvbvbvbvbvbvbvbvbvbvbpaaaaaaaaaaaaaaaaaaaaaaaaaaaaaaaaaaaaaaaaaaaaaaaaaaaaaaaaaaaaaaaaaa
bpbpbpbpbpbpbpbpbpbpbpbpbpbpbpbpbpaaaaaaaaaaaaaaaaaaaaaaaaaaaaaaaaaaaaaaaaaaaaaaaaaaaaaaaaaaaaaaaaaa
"}
